NO textures/grey_stone.xpm
SO textures/purple_stone.xpm
WE textures/red_brick.xpm
EA textures/wood.xpm

C 1,0,255
F 225,225,225

        111111111111111111111111
        1000000000110000000000001
        1011000001110000000000001
        1001000000000000000000001
111111111011000001110000000000001
1N0000000001100000111011111111111
101110111111111011100000000001
11110111111111011101010010001
11000000110101011100000010001
10000000000000001100000010001
10000000000000001101010010001
11000001101010111110111100111
11110111 1110101 101111010001
11111111 111111 111111111111
